
{
  "id": "village_area",
  "map": [
    [4, 4, 4, 4, 4, 4, 4, 4, 4, 4, 4, 4, 4, 4, 4, 4, 4, 4, 4, 4, 4, 4, 4, 4, 4],
    [4, 4, 4, 4, 4, 4, 4, 4, 4, 4, 4, 4, 4, 4, 4, 4, 4, 4, 4, 4, 4, 4, 4, 4, 4],
    [4, 4, 4, 4, 4, 4, 4, 4, 4, 4, 4, 4, 4, 4, 4, 4, 4, 4, 4, 4, 4, 4, 4, 4, 4],
    [4, 4, 4, 4, 4, 4, 4, 4, 4, 4, 1, 1, 1, 1, 1, 1, 1, 4, 4, 4, 4, 4, 4, 4, 4],
    [4, 4, 4, 4, 4, 4, 4, 4, 4, 4, 1, 2, 2, 2, 2, 2, 1, 4, 4, 4, 4, 4, 4, 4, 4],
    [4, 4, 4, 4, 4, 4, 4, 4, 4, 4, 1, 2, 2, 2, 2, 2, 1, 4, 4, 4, 4, 4, 4, 4, 4],
    [4, 4, 4, 4, 4, 4, 4, 4, 4, 4, 1, 1, 2, 2, 1, 1, 1, 4, 4, 4, 4, 4, 4, 4, 4],
    [4, 4, 4, 4, 4, 4, 4, 4, 4, 4, 4, 4, 4, 4, 4, 4, 4, 4, 4, 4, 4, 4, 4, 4, 4],
    [0, 0, 0, 0, 0, 0, 0, 0, 0, 0, 0, 0, 0, 0, 0, 0, 0, 0, 0, 0, 4, 4, 4, 4, 4],
    [0, 0, 0, 0, 0, 0, 0, 0, 0, 0, 0, 0, 0, 0, 0, 0, 0, 0, 0, 0, 4, 4, 4, 4, 4],
    [0, 0, 0, 0, 0, 0, 0, 0, 0, 0, 0, 0, 0, 0, 0, 0, 0, 0, 4, 4, 4, 4, 4, 4, 4],
    [4, 4, 4, 4, 4, 4, 4, 4, 0, 0, 0, 0, 0, 0, 0, 0, 0, 1, 1, 0, 0, 1, 1, 1, 4],
    [4, 4, 4, 4, 4, 4, 4, 4, 0, 0, 0, 0, 0, 0, 0, 0, 0, 1, 4, 4, 4, 4, 4, 1, 4],
    [4, 4, 4, 4, 4, 4, 4, 4, 0, 0, 0, 0, 0, 0, 0, 0, 0, 1, 4, 4, 4, 4, 4, 1, 4],
    [4, 4, 4, 4, 4, 4, 4, 4, 0, 0, 0, 0, 0, 0, 0, 0, 0, 1, 4, 4, 4, 4, 4, 1, 4],
    [4, 4, 4, 4, 4, 4, 4, 4, 4, 4, 4, 4, 4, 4, 4, 4, 4, 1, 1, 1, 1, 1, 1, 1, 4],
    [4, 4, 4, 4, 4, 4, 4, 4, 4, 4, 4, 4, 4, 4, 4, 4, 4, 4, 4, 4, 4, 4, 4, 4, 4],
    [4, 4, 4, 4, 4, 4, 4, 4, 4, 4, 4, 4, 4, 4, 4, 4, 4, 4, 4, 4, 4, 4, 4, 4, 4]
  ],
  "enemies": [],
  "npcs": [
    {
      "startX": 5, "startY": 5,
      "id": "sabo", "name": "賢者サボ",
      "questId": "monster_extermination_1",
      "type": "quest"
    },
    {
      "startX": 21, "startY": 12,
      "id": "shopkeeper", "name": "店主",
      "type": "shop"
    },
    {
      "startX": 15, "startY": 4,
      "id": "arena_master", "name": "アリーナマスター",
      "type": "arena_entry"
    }
  ],
  "treasureChests": [
    { "startX": 22, "startY": 2 }
  ],
  "healingZones": [
    { "startX": 8, "startY": 10, "width": 2, "height": 2 }
  ],
  "doors": [
    {
      "startX": 13,
      "startY": 3,
      "targetRoomId": "final_boss_chamber",
      "targetPlayerX": 384,
      "targetPlayerY": 480,
      "condition": {
        "type": "boss_defeated",
        "id": "dungeon_guardian_1"
      }
    }
  ],
  "exits": {
    "left": { "targetRoomId": "field_area" }
  }
}
